延	诞	蜒
奄	掩	淹	俺
彦	颜	谚
央	秧	映	殃	泱
扬	杨	汤	场	肠	烫
羊	详	样	洋	鲜	群	祥	翔
坐	座	挫	痤
夭	袄	沃	跃	妖
尧	饶	绕	浇	挠	烧	侥	跷	娆	骁	晓
遥	摇	瑶	谣
舀	稻	蹈
也	弛	驰	施
页	顽	烦	顿	领	顺	须	颇
亦	迹	峦	恋	蛮	变	弈	奕 
译	择	泽	驿	绎 
易	惕	踢	剔	锡	赐 
永	咏	泳	脉
甬	通	痛	桶	诵	捅	俑	涌	蛹	踊	恿	用	拥	佣	痛	疼	病
尤	龙	忧	优	伏
由	迪	笛	宙	油	邮	抽	袖	柚	庙 
酉	酒	酥	酬	醉	配	酿
又	权	杈 
幼	窈	坳	拗 
于	宇	吁	迂	圩	纡
余	涂	途	斜	叙	徐	除
鱼	鳅	鲜	鳍	鲸	鲇
俞	愉	逾	渝	揄	输	愈	榆	喻	偷	瑜	觎	谕
羽	翎	翔	翩	翘	翻	翅	翱	翠 
雨	两	霎	雾	雷	雪	霜	霆	雹
聿	律	津	肄	肆
元	远	完	玩	园
员	陨	损	捐
原	愿	源
援	暖	缓 
约	药 
月	朋	膊	脯	育	肓	盲	脊	背 
云	芸	动	运	耘
匀	均	钧 
赞	替	潜
燥	操	躁	澡	藻	噪	嗓
则	测	侧	铡 
炎	淡	谈
乍	作	昨	咋	诈	炸	榨 
詹	檐	瞻	赡	谵 
斩	渐	崭	暂 
展	辗	碾 
占	沾	粘	站	战	黏	帖	贴	玷	苫
章	障	彰	獐
召	招	照	沼
兆	挑	桃	窕	逃	佻	跳	眺
者	诸	猪	储	赌	睹	堵	都	煮 	署	署	躇	绪	著
真	慎	填 
诊	珍	趁	殄	畛 
正	证	征	歪	焉	惩	症	政
之	乏	芝	泛	眨
支	枝	技	歧	鼓	肢	岐 
直	植	值	殖	置
上	止	址	趾	耻	让	企	扯	肯
只	识	织	职	枳	帜
至	侄	窒	倒	到	致 
舟	舰	航	杭	抗	炕  
朱	株	珠 
主	注	往	柱	驻	住	拄
维	推	堆	准	难	唯	 惟	谁	雕	雅	稚	雏
状	壮	妆
卓	桌	绰	悼	掉	婥	棹	淖	倬	焯 
兹	慈	滋	磁	糍
宗	棕	综	踪	淙	崇	祟
走	趣	趋	越	起	趟	超	陡	徒
奏	凑	揍	挨 
吴	误	娱
半	伴	拌	胖	绊	叛	判
金	全	链	键	钱	铜	针 
孚	俘	浮
累	骡	螺	摞 
秋	愁	揪	鳅
区	匹	沤	躯	驱	岖	欧	殴	讴	呕	怄	抠	枢	伛	妪	鸥
屈	掘	倔 
刃	忍	仞
容	蓉	熔	溶	榕	融 
赛	塞	寒
尚	躺	淌	趟	倘 
勺	趵	钓	约	的	灼	匀	勾	均	钩	沟 
少	妙	纱	抄	沙
申	神	伸	坤	绅	呻	审 
身	射	躲 
甚	堪	斟	勘	湛	戡	椹
生	性	姓	星 
豕	逐	琢	啄 
摭	遮 
世	屉	泄	蝶	碟	喋	牒	谍	堞
市	闹	柿
示	标	祭	票	际
式	拭	试	轼 
是	提	题	堤
寿	涛	祷	踌	铸	畴	俦	筹	等 
殳	役	投	没	般	设	股	服
叔	淑	椒	督 
斯	撕	嘶	厮
寺	持	等	待	诗	侍	特	恃	峙 
堂	瞠	膛 
廷	挺	庭	霆	艇	蜓 
童	幢	憧	撞
宛	碗	婉	腕	蜿	惋
亡	忙	虻	芒	茫
王	玉	斑	班	狂	枉
琴	瑟
危	跪	桅	诡	脆
廓	廊
委	萎	魏	巍 
我	峨	娥	饿	俄	鹅 
吾	语	捂	悟	梧	晤
貌	藐 
控	腔
姆	母	拇
势	执	挚 
康	糠	慷
州	洲	渊
嘱	瞩
沁	泌	心	必
殊	铢
丞	承
昔	猎	借	错	蜡	惜	腊	鹊	措
暇	假	霞	瑕	遐
咸	减	喊 	感	惑
献	现 
相	箱	霜	湘
向	响	晌 
肖	消	梢	销	锁	捎	悄	哨	稍	硝	霄	宵
辛	瓣	辩	辫	辨	辞	辟	避	宰	辣 
秀	锈	绣	诱	透 
需	懦	儒
玄	弦	舷	眩
穴	窘	穷	空	窈	窕 
寻	灵	雪	扫
夸	垮	跨	挎	胯	污
兰	拦	栏	烂
阑	澜	斓	谰
劳	涝	捞 
乐	砾	烁
里	埋	理	狸	童	撞	幢
矛	予
力	边	动	劫	励	历 
历	厉	历	励	沥	枥	砺
立	拉	垃	站	粒	泣	笠
利	俐	犁	梨 
连	链	莲
良	娘	狼	酿 	粮	艮	狠	恨	狼	娘	恳	垦 
撩	嘹	潦	了	燎	镣	瞭	缭
列	例	烈	裂	冽	咧
林	婪	楚	梦	禁 
临	监	鉴	篮	蓝 
嶙	粼	磷	麟	鳞 
今	令	怜	伶	邻	冷	领	龄	铃	岭	玲	拎	翎
留	榴	瘤	溜	遛
龙	拢	笼	庞	宠	茏	垄
娄	楼	搂	数	缕	偻	褛	蒌	屡	喽
录	碌	逮	剥	绿	缘
吕	宫	铝	铅
率	摔	蟀
仑	纶	论	沦	伦	抡	轮 
罗	萝	箩	逻	锣
麻	磨	摩	魔	靡	糜	縻 
马	驼	驮	驱	驰	妈	吗	骂 
廓	廊
曼	慢	漫	蔓	馒	幔	谩
毛	毡	毯	毫
每	海	诲	悔	霉	晦	梅	侮 
门	闲	闷	闭	闯	阔	闪 
米	继	断	眯	迷	谜 
免	兔	挽	勉	冕	晚	娩	搀	馋	逸
面	腼	缅	湎 
苗	描	猫	瞄
皿	盐	监	盆	岔	盒	孟	猛	盂	盘
莫	漠	膜	模	摸
某	谋	媒	煤 
木	本	沐	林	材	村	柄	栖	柩	框	筐	眶
内	柄	纳	呐 
那	哪	挪	娜 
难	滩	摊	瘫
魅	魁
将	奖	浆	蒋
衅	畔
哀	衰	衷	蓑	袁	猿 
拴	栓
吼	孔 
旺	汪
忖	村	讨	对
陶	掏	淘	啕
瘦	病	疗	疼	痒
鸟	乌	岛	鸣	呜	（吗）	莺	鹅	鹊	鹤
宁	狞	拧	柠
农	浓
奴	努	怒	恕	弩
妥	要	耍
旁	滂	螃	榜	膀	傍	谤	磅	镑	髈
皮	破	波	坡	彼	被	玻	披	疲	跛	皱	菠
票	飘	漂	膘 
齐	济	挤	剂	跻	脐
其	斯	期	欺	旗
奇	绮	畸	崎	椅	倚	骑	寄	犄	犄	掎	漪	旖
契	楔	揳
掐	陷	馅 
千	纤	迁	阡	歼	忏	芊	竿
险	检	验	脸	签	捡	俭 
欠	炊	吹	欢	观	饮	钦	坎	次	软	砍	欣
乔	骄	桥	轿	娇	侨	矫
切	彻	砌	沏 
且	阻	组	谊	宜	咀	徂	狙	沮	龃	趄	诅	俎	租	祖	粗
高	篙	嵩	蒿	稿	搞	缟	槁	镐
哥	歌
隔	融	嗝
各	名	骆	路	洛	络
亘	恒	宣	喧	楦	渲	桓	垣	晅	萱	暄	喧	烜
谮	僭
更	硬	便	梗	粳	哽 
共	洪	拱	哄
勾	构	钩	沟	购	狗	够
故	敌	做	坐	座
骨	滑	猾 
瓜	孤	狐	抓	弧
官	馆	管	营	棺 
贯	惯	掼
广	旷	矿
圭	蛙	娃	洼	桂	挂	佳	涯	崖	封	畦	哇	卦
鬼	瑰	愧	槐	魏	魄	魂	魔
贵	溃	绩	遗	 匮	馈	遣	聩	篑	愦
果	棵	颗	课	稞	踝	窠	裸 
亥	该	核	咳	刻	垓	赅	陔	劾
合	哈	拾	答	给	塔	搭	恰
曷	渴	喝	竭	褐	揭	碣	遏	偈	谒 
黑	默	墨	黝
胡	糊	蝴	湖	瑚	葫  
虎	虚	虑	虔	虐
户	庐	炉	房	妒	驴	护
奂	焕	涣	换	焕	唤	
简	筒
灰	诙	恢	碳	炭
火	灾	烧	煤	烤	炎	焚	灭	伙	
及	级	极	汲	吸	圾
吉	结	洁	桔	劼	诘	拮	（枯）
急	稳	隐	瘾
几	讥	凯	饥	肌	机
己	已	记	纪	妃
既	溉	慨	概
加	驾	架 
夹	狭	峡	挟	侠	荚	颊
家	稼	嫁
兼	歉	赚	嫌	谦	廉 
监	滥	槛
观	现	砚	觉	视 
建	健	毽	腱	键
笺	残	浅	线	钱	贱	践	溅	栈	饯 
键	健 
奖	桨	浆	酱
交	狡	校	郊	胶	效	跤	饺	绞	咬	佼	皎	姣	绞	纹
皆	楷	谐 
介	价	阶 
斤	斥	折	析	拆	近	浙	逝	哲	暂	晰	听	斩	崭	断 
堇	谨	勤
京	凉	谅	晾	景	惊	掠
经	茎	泾	径	劲	颈
大	太 
竟	镜	境	竞 
敬	警	擎	儆 
居	据	剧
句	包	苞	苟
巨	矩	柜	拒	距	炬
具	惧	俱	飓
倦	蜷	卷	券	誉	誊	誊	举 
诀	决	块	夸	缺	快	扶
厥	橛	獗
军	浑	挥	晕	晖	辉
君	群	裙
峻	俊	骏	竣	浚	悛	逡	唆	梭	焌
开	形	刑	型	荆
亢	坑	炕	抗	吭	沆
敖	熬	傲	遨	赘
白	怕	帕	伯	拍	泊	柏	陌	珀
佰	宿	缩
办	苏	协	胁
邦	帮	绑	梆
包	跑	炮	泡	抱	袍	饱	苞	刨	咆
暴	爆	瀑	曝 
卑	脾	牌	碑	啤	稗	捭	婢	裨
责	负	贫	贪	财	账	赊	贺	货 
贲	喷	愤 
本	笨	体	休
必	密	蜜	秘
敝	蔽	憋	鳖	弊
辟	避	癖	劈	壁	璧
扁	匾	偏	翩	篇	遍	骗	编	蝙 
并	拼	饼	迸	开
搏	博	傅	薄	礴	缚	膊 
卜	补	扑	朴	仆
不	坏	环	丕	歪	否	怀	杯	还
部	陪	倍
才	寸	财	材
采	彩	睬	踩	菜
参	掺	惨	渗
仓	沧	苍	伧	枪	抢	疮	呛	炝	创
曹	糟	嘈	遭	槽
查	渣	碴
涨	胀	张
朝	潮	嘲	瀚 
澈	撤	撒	辙
辰	唇	晨	震	振	辱
成	城	域	诚	盛
虫	独	浊	蛋	蚕	蛰	蜇
丑	扭	钮	纽	羞 
出	屈	拙	倔	掘	咄	茁	绌
刍	皱	煞	邹 
啜	掇	缀	裰	辍	惙
喘	揣	端	湍	瑞	惴
串	患	窜
垂	陲	睡	锤	棰	捶 
此	柴	紫	紧	些	比
次	资	咨	姿	羡
从	丛	纵	众	枞
崔	摧	催
寸	守	宇	字	付	衬	村	时	对	过	讨	过	辽	疗
旦	胆	但	担	坦
当	挡	档	铛
登	凳	橙	蹬	澄	噔	瞪
帝	啼	谛	缔	蒂	蹄	啻
甸	句	勾
丁	订	钉	叮	盯	打
东	车	冻	栋	军
斗	抖	科	斟	魁	料
段	断
兑	悦	说	脱	阅
多	侈	移	够	哆
尔	你	弥	猕 
耻	职	取	联	聘	娉	俜	骋
抚	芜
反	版	板	饭	返	贩	扳
方	防	访	妨	纺	旅	仿	彷
非	韭	霏	排	匪	徘	悲	辈	菲	翡	绯	诽	扉	斐	蜚
分	粉	芬	份	纷 
风	凤	飘	飚	飒	枫	疯	讽
逢	缝	蓬	篷	峰	锋	逢	蜂 
奉	棒	捧
夫	无	天	扶	肤
弗	沸	拂	佛 
幅	副	逼	福	富	蝠
甫	捕	辅	哺	铺	浦	搏	脯	膊	蒲	敷
亨	享
复	履	覆	屐
干	十	秆	杆	轩	竿	汗
甘	钳	甜	柑
冈	刚	钢	岗	纲
婵	蝉	箪	殚	掸	惮	禅
瞅	啾	揪	锹	楸	湫
颁	颔	颌	颀	硕	顶	项	颐
盎	蛊	盂	盅
妲	怛	袒 
淄	缁	辎	锱 
秕	妣	庇	毖	纰	砒	毗	枇	蚍
添	漆
睢	雎
胳	骼	恪	络	烙	咯	落	格	骆
烩	荟	桧	侩	刽 
浼	娩	冕	晚	挽 
西	酉	牺	栖	洒	晒	哂	酒
邗	邛	顼	顸
龚	龛	詟	垄	陇 
岫	柚	轴	舳
谬	缪	缪	戮	戳
估	轱	沽	牯	钴	诂	怙	祜	佑	古	枯	苦	若	姑
揩	楷	锴	谐	偕	喈
蹇	搴	褰	骞
戢	缉	楫	辑 
授	援
扰	犹	拢
洎	汨	汩
扛	杠
井	并
龌	龊	龃	龉
麋	鹿	麇	麂
怠	殆	骀	饴	怡	贻
罐	灌
囊	壤	攘	镶	嚷	瓤
躁	臊	澡	操	噪	燥	藻
麻	磨	蘑	摩	靡	魔	麾
尊	遵	蹲	樽	奠
疆	僵
籍	藉
赞	攒 
暴	爆	曝	瀑
辟	避	璧	譬	僻	臂	壁	劈
鞠	掬	菊 
复	腹	覆	馥	蝮	履
辨	辫	辩	瓣 
焦	蕉	礁	瞧	憔	樵 
卒	碎	醉	萃	瘁	粹	翠	悴	猝	淬	率
付	附	咐	驸	府	俯	腐 
缴	激	邀
攀	拳	掌	撑 
胡	湖	蝴	糊
箱	相	湘	厢	想 
官	宫
圃	匍	蒲
满	瞒	蹒 
景	影
采	彩	睬	踩	菜
瓜	爪
叉	义	又
朋	棚	鹏	绷
谁	唯	维	推	雕	难	雅	稚	崔	摧	催	璀	雏
替	潜
治	冶	洽
杂	朵
远	运
央	奂	英
尤	犬
昆	混	棍
周	凋	调	绸	稠	惆	碉	雕
用	甩
阴	阳
我	找
暮	蓦	墓	幕	慕	摹	寞 
象	像	橡 
樱	婴	鹦
告	浩	结	洁	皓	靠	诰	梏	鹄 
牙	呀	芽	雅	讶 
漆	膝
勿	忽	匆	葱
繁	敏
谷	俗	裕	豁	浴	欲
亭	停	婷 
曾	赠	憎	僧	蹭	嶒	兽
水	木
手	乎	平 
具	真	其
真	镇 
互	瓦
祛	怯 
揭	竭
日	曰
人	入	八
旧	归
荒	谎	慌	流
旬	询	殉 
亡	芒	茫	忙	盲	氓
侯	候
舌	活	话	括	乱	刮	适 
弟	第	递	梯	剃	涕
何	河
儿	几	九	丸	几	凡
处	外
京	惊	凉	晾	谅	掠 
少	沙	吵	抄	炒	妙	纱
巨	拒	炬	距	矩	柜
秀	绣	锈	透
参	惨	渗 
当	挡	档 
居	剧	据	倨	锯	踞 
会	侩	脍 
夸	挎	垮	胯	跨 
卜	补	扑	仆	朴	赴
萄	淘	陶	掏 
赏	堂	堂	党	赏	党	裳	掌	撑	棠	常	尝	偿
丰	半	峰	锋	烽	蜂	逢	缝	蓬
敝	弊	蔽	撇	蹩	瞥
载	栽	裁
票	漂	缥	飘	剽	瓢	膘	栗	粟 
争	筝	铮	峥	睁	挣	诤	狰	净	静
庄	压
奥	粤
需	儒	孺	濡	 蠕	嚅	懦
田	甲	由	申	电
买	卖	读	渎	椟	黩	犊	续	赎	牍
黑	墨	默	黩	黯	黔 
尉	慰	蔚	熨 
召	诏	招	昭	沼 
章	彰	樟	璋	蟑 
蹈	稻	滔	韬 
韦	违	苇	讳	伟	违	纬
史	驶	使 
仰	昂	迎	抑 
台	抬	胎	苔	怡	治	冶	始
很	银	限	艰	根	跟	狠
捷	睫
贪	念	妗	吟
兵	滨	缤	摈	傧	宾	乒	乓
汛	迅	讯 
哭	骂	咒	器	嚣
前	煎	剪
田	奋	备	思	佃	亩	腮	思	崽
青	清	晴	情	晴	静	请	睛	精	猜	靓	靛	倩
爪	瓜	爬	抓 
因	咽	胭	烟 	困
十	什	计	针	叶	汁 
弓	引	张	弯	湾 
乃	仍	奶	及	吸	极	级	扔
斥	诉	拆
公	讼	松 
乖	乘	剩
旱	捍	悍
蒙	檬	朦	曚
偶	遇	寓	藕	隅
幻	幼 
部	剖	陪	培	倍	赔	蓓
乙	乞	气	艺	忆	迄	屹	亿
八	扒	趴	穴	叭
帛	绵	棉	锦
唐	塘	搪	糖
称	你
仗	杖 
废	疲 
促	捉 
品	晶
摘	滴
坚	竖 
庆	厌 
国	固
雀	省
左	在
熟	热	塾
室	宝 
帅	师 
嬴	蠃	羸	赢
伺	饲
椽	喙	蠡	掾	缘
磬	罄	謦
忻	沂	斫	昕
戍	戎	戊	戌
婺	骛	鹜
宥	囿	侑
柝	坼	
醇	淳	谆	敦 
纂	篡 
赧	赦
苘	茼
杳	沓
靥	魇 
敝	弊	蔽
卌	卅
蓝	篮 
诟	逅
嬉	禧	僖	熹	嘻
谡	稷
掣	擎	警
膺	赝
箫	萧
磋	蹉
谓	猬
阵	陈
伐	代
豪	毫
右	石
郎	朗	踉	粮 
屋	层
贝	见	欠
灿	仙	讪
冒	昌
茵	菌
思	恩
类	粪
考	老
导	异	寻
麻	床
脏	桩
耳	且	目	茸 	耸	洱	珥	饵	佴	咡 	咀
内	肉
缺	缸
找	戏	伐
绳 	蝇	渑
货	贷	袋
度	贷
否	杏
土	士
用	甩
于	干	千
喂	偎	畏
究	穷	突
传	转	砖
拣	练	炼	冻
肚	吐	 杜
爱	受	援
劝	动	功	切
池	地	驰
间	闻	问	闷
平	评	苹	萍
洗	宪	冼	选
显	星	湿 
义 	议	仪	蚁
末	未	味	昧	抹
勃	脖 
恰	洽 
脊	瘠 
探	深 
客	容 
派	旅 
息	熄
诺	若	苦
冠	寇 
茶	荼
御	卸
侵	浸	寝
媚	眉
梁	粱
欣	颀	掀	折
耽	眈	忱	枕
碍	得
拔	拨	托	拖
崩	蹦
呙	娲	祸	剐	锅	涡	蜗
即	既
放	旅	旋	族
叨	叼	刀	刁	力	刃
铭	茗	酩 	名	各
岷	泯	眠	民	氏
踏	蹋	榻
翼	冀
葵	擦	察	祭
捆	困	团	闭	闲 	因
度	渡	镀	席 
谥	隘	缢	溢	镒
舸	呵	苛	轲	柯	疴	坷
侗	恫	胴	桐
惦	掂
删	跚	姗	珊
纾	抒	妤	杼
祗	诋	邸	柢	砥	抵	泜	胝	氏	纸	低	底	抵	邸
荧	萤	莹
碛	啧
阙	阕
皴	皲
涤	绦
抱	抢	抡









